0060,0360,0366,0520,0400,0400,0688,0000,0000,0000,0000,0140
0000,0180,0224,0204,0666,3030,0000,0000,0000,0000,0060,0200
0044,0400,0590,0000,0000,0000,0000,0000,0000,0000,0000,0600
0055,0470,0530,0000,0000,0000,0000,0000,0000,0000,0000,0900
0066,0400,0668,0000,0000,0000,0000,0000,0000,0000,0000,0300
0284
2020
0030
